Chaotic scene in a space cantina, aliens with too many eyes and teeth brawling over spilled drinks, flying chairs and neon lights everywhere. Spray-painted on the wall: “I NEED BUZZ”.
Post-apocalyptic carnival – mutant clowns juggling chainsaws, bumper cars on fire, cotton candy machines exploding in sparks. On a collapsing tent wall: “I NEED BUZZ”.
Medieval tavern brawl – knights in rusty armor throwing turkey legs, drunk monks wrestling pigs, lute smashed over someone’s head. Carved into the wooden beam above the bar: “I NEED BUZZ”.
Cyberpunk ramen bar – androids slurping noodles, holograms glitching, someone hacking the jukebox to blast static. Neon graffiti on the steaming kitchen wall: “I NEED BUZZ”.
Haunted amusement park – Ghosts fighting over popcorn, zombies riding rollercoasters backwards, demonic mascots chasing kids. In dripping ectoplasmic paint: “I NEED BUZZ”.
Pirate ship chaos – Parrots cursing in 10 languages, cannons firing by accident, drunken pirates fencing with fish. Scratched into the mast: “I NEED BUZZ”.
Futuristic gladiator arena – Robots malfunctioning mid-fight, lasers shooting randomly into the crowd, vendors selling radioactive hotdogs. Holo-banner glitching with the words: “I NEED BUZZ”.
Underground punk concert – Half the band is on fire, mosh pit full of goblins, amps sparking like tesla coils. Spray-painted behind the stage: “I NEED BUZZ”.
Victorian tea party gone wrong – Gentlefolk sword-fighting with umbrellas, teapots exploding like grenades, clouds of scones in the air. On the cracked porcelain wall: “I NEED BUZZ”.
Kaiju wrestling ring – Giant lizards in luchador masks pile-driving skyscrapers, referees crushed under tails, popcorn raining from blimps. Across the jumbotron in spray-paint: “I NEED BUZZ”.
Infernal fast-food joint – Demons deep-frying souls, grease fires everywhere, gargoyles throwing burgers at angels. Burned into the fryer hood: “I NEED BUZZ”.
Steampunk airship saloon – Brass automatons spilling oil on the dance floor, monocled captains dueling with steam-powered pistols, gears flying. On a torn dirigible banner: “I NEED BUZZ”.
Jurassic rave party – Raptors in glowsticks breakdancing, a T-Rex DJ smashing turntables with tiny arms, confetti volcano eruptions. Projected on the cave wall: “I NEED BUZZ”.
Apocalyptic shopping mall – Mutant shoppers battling with shopping carts, escalators reversing at high speed, mannequins rioting. Spray-painted on a shattered storefront: “I NEED BUZZ”.
Haunted library riot – Poltergeists throwing books, cursed tomes flapping like bats, librarians wielding chainsaws for silence. On a levitating grimoire: “I NEED BUZZ”.
Outer space rodeo – Astronauts riding exploding asteroids, cyborg cowboys lassoing black holes, alien bulls trampling satellites. Hovering neon sign flickering: “I NEED BUZZ”.
Gothic cathedral food fight – Vampires hurling chalices of blood, gargoyles puking stone, choirboys launching baguettes like rockets. Scrawled across the altar: “I NEED BUZZ”.
Wild west saloon in VR – Cowboys glitching in and out of existence, tumbleweeds coded in binary, pistols shooting emojis. Floating HUD graffiti: “I NEED BUZZ”.
Mutant beach party – Giant crabs stealing surfboards, radioactive jellyfish DJing on vinyl, sandcastles collapsing like nukes. Written in seaweed on the tide: “I NEED BUZZ”.
Candy factory meltdown – Chocolate rivers flooding the floor, gummy bears rioting with lollipops as weapons, Oompa Loompas on strike throwing sugar bombs. On a giant caramelized wall: “I NEED BUZZ”.
Alien zoo escape – Tentacled beasts breaking cages, tourists running with stolen cotton candy, space zookeepers tasered by their own drones. Laser-scorched on the glass dome: “I NEED BUZZ”.
Underground mutant subway – Rats the size of horses crowd-surfing, slime dripping from the ceiling, possessed vending machines spitting sodas like bullets. Spray-painted across the tunnel: “I NEED BUZZ”.
Arctic disco catastrophe – Polar bears in glitter suits ice-skating badly, walruses DJing with tusks, igloos collapsing under strobe lights. Carved in glowing ice: “I NEED BUZZ”.
Time-traveling diner – Romans arguing with cowboys over pancakes, samurais sword-fighting astronauts, waitresses teleporting by mistake. Written in ketchup on the counter: “I NEED BUZZ”.
Haunted kindergarten – Ghost toddlers throwing crayons, possessed teddy bears eating glue, juice boxes exploding like grenades. Scribbled on the chalkboard: “I NEED BUZZ”.
Post-human dog park – cyber poodles chasing drones, bulldogs riding hoverboards, cats running a black-market fish stand. Graffiti on the fence: “I NEED BUZZ”.
Fantasy RPG tavern glitch – Orcs rage-quitting mid-drink, wizards miscasting fireballs into the ale barrels, elves stealing quest logs. On a floating quest banner: “I NEED BUZZ”.
Nuclear bowling alley – Pins mutating into tentacles, radioactive balls glowing and cracking the floor, bowlers sprouting extra arms mid-throw. Spray-painted above the scoring screen: “I NEED BUZZ”.
Space kindergarten bus – Kids with antennae throwing slime at the driver, zero-gravity crayons floating everywhere, black hole forming in the lunchbox. On the scratched window: “I NEED BUZZ”.
Martian opera house – aliens screaming arias, chandeliers crashing. Curtain tag: “I NEED BUZZ”.
Underwater disco – jellyfish DJ, sharks crowd-surfing. Coral wall glowing: “I NEED BUZZ”.
Robo-cat café – malfunctioning android cats spilling lattes. Foam art: “I NEED BUZZ”.
Intergalactic laundromat – wormholes in washing machines. Dryer door graffiti: “I NEED BUZZ”.
Zombie parliament – undead politicians throwing brains. Speaker’s chair etched: “I NEED BUZZ”.
Circus in a black hole – acrobats stretched into infinity. Event horizon spray: “I NEED BUZZ”.
Alien kindergarten art class – tentacles with crayons, slime finger paint. Wall scribble: “I NEED BUZZ”.
Demonic ice cream truck – cones on fire, possessed sprinkles. Side panel tag: “I NEED BUZZ”.
Space casino brawl – slot machines bleeding coins. Neon jackpot sign: “I NEED BUZZ”.
Kaiju beach volleyball – skyscraper-sized monsters diving. Net spray: “I NEED BUZZ”.
Skeleton jazz club – bones used as trumpets, ghosts dancing. Stage mural: “I NEED BUZZ”.
Radioactive farmyard – mutant chickens laying glowing eggs. Barn wall spray: “I NEED BUZZ”.
Moon prison riot – convicts floating, guards with jetpacks failing. Cell wall scratch: “I NEED BUZZ”.
Carnival of cursed puppets – marionettes strangling the audience. Big top banner: “I NEED BUZZ”.
Cosmic skatepark – comets grinding rails, astronauts crashing. Ramp graffiti: “I NEED BUZZ”.
Mutant hospital ER – doctors with extra arms juggling scalpels. X-ray glowing: “I NEED BUZZ”.
Giant insect courtroom – cockroach judge banging gavel. Bench engraving: “I NEED BUZZ”.
Necromancer sushi bar – skeletons eating cursed sashimi. Menu board: “I NEED BUZZ”.
Alien kindergarten nap time – monsters snoring lasers. Ceiling doodle: “I NEED BUZZ”.
Steam-powered boxing match – automatons leaking oil mid-punch. Ring mat: “I NEED BUZZ”.
Supermarket apocalypse – shopping carts battling like tanks. Freezer door spray: “I NEED BUZZ”.
Cosmic circus train – wagons on fire, lions juggling planets. Caboose graffiti: “I NEED BUZZ”.
Demonic pet show – three-headed dogs chasing judges. Trophy etching: “I NEED BUZZ”.
Mutant traffic jam – cars with teeth biting pedestrians. Billboard tag: “I NEED BUZZ”.
Carnival in a volcano – lava clowns juggling fireballs. Rock wall spray: “I NEED BUZZ”.
Post-apocalyptic wedding – radioactive cake exploding. Banner: “I NEED BUZZ”.
Haunted swimming pool – ghost lifeguards, chlorine fog. Diving board scrawl: “I NEED BUZZ”.
Cybernetic rodeo clowns – hacking the bulls mid-ride. Arena screen: “I NEED BUZZ”.
Alien flea market – tentacles trading junk, chaos everywhere. Booth sign: “I NEED BUZZ”.
Mutant ice hockey match – sticks melting, goalie with ten heads. Ice carving: “I NEED BUZZ”.
Astral kindergarten play – toddlers summoning demons with finger paint. Stage curtain: “I NEED BUZZ”.
Viking karaoke bar – warriors screaming into flaming mics. Banner: “I NEED BUZZ”.
Cosmic bowling league – comets smashing pins. Scoreboard glitch: “I NEED BUZZ”.
Haunted fashion show – zombies modeling decayed gowns. Runway spray: “I NEED BUZZ”.
Galactic pet grooming salon – alien fur clogging drains. Mirror tag: “I NEED BUZZ”.
Time-loop carnival – rides repeating forever, screaming eternally. Clock face: “I NEED BUZZ”.
Post-human chess tournament – pieces mutating mid-game. Board carving: “I NEED BUZZ”.
Neon graveyard rave – skeletons glow-dancing. Tombstone tag: “I NEED BUZZ”.
Apocalypse daycare – babies with flamethrowers. Crib wall: “I NEED BUZZ”.
Cursed circus aquarium – sharks on unicycles. Tank graffiti: “I NEED BUZZ”.
Astronaut barbecue – grilling meteors, smoke in zero-g. Grill lid: “I NEED BUZZ”.
Mutant opera rehearsal – singers exploding mid-note. Sheet music: “I NEED BUZZ”.
Alien hair salon – tentacle stylists burning wigs. Mirror spray: “I NEED BUZZ”.
Kaiju chess match – skyscrapers as pieces. Ruins etched: “I NEED BUZZ”.
Werewolf laundromat – fur clogging machines, chaos. Dryer door: “I NEED BUZZ”.
Post-apocalyptic clown car – exploding pies, flames inside. Side panel spray: “I NEED BUZZ”.
Alien drive-thru – tentacles serving burgers, cars floating. Menu board: “I NEED BUZZ”.
Demonic spelling bee – kids vomiting letters. Chalkboard spray: “I NEED BUZZ”.
Cyber samurai disco – neon katanas slicing lights. Dance floor tag: “I NEED BUZZ”.
Zombie fast-fashion store – mannequins biting customers. Dressing room wall: “I NEED BUZZ”.
Mutant ice cream festival – cones melting into goo monsters. Booth banner: “I NEED BUZZ”.
Interdimensional courtroom – judges phasing in and out. Wall scribble: “I NEED BUZZ”.
Alien kindergarten birthday – cake explodes, balloons screaming. Ceiling spray: “I NEED BUZZ”.
Pirate karaoke night – parrots screeching metal songs. Stage wall: “I NEED BUZZ”.
Astral pet cemetery – ghost dogs chasing skeleton cats. Gravestone tag: “I NEED BUZZ”.
Necromancer cooking show – skeletons chopping cursed onions. Counter spray: “I NEED BUZZ”.
Kaiju disco inferno – skyscraper-sized monsters dancing badly. Disco ball tag: “I NEED BUZZ”.
Vampire roller derby – fangs out, blood on wheels. Arena wall: “I NEED BUZZ”.
Haunted bowling alley – ghost pins howling. Lane spray: “I NEED BUZZ”.
Martian theme park – rides collapsing in dust storms. Gate graffiti: “I NEED BUZZ”.
Post-apocalyptic puppet theater – dolls strangling audience. Curtain spray: “I NEED BUZZ”.
Astronaut rodeo – lassoing meteors, helmets cracking. Arena board: “I NEED BUZZ”.
Zombie science fair – projects exploding, undead teachers. Poster board: “I NEED BUZZ”.
Alien coffee shop – slime lattes, customers with ten mouths. Foam tag: “I NEED BUZZ”.
Robot kindergarten chaos – sparks flying, crayons as weapons. Wall scribble: “I NEED BUZZ”.
Mutant carnival parade – floats melting, clowns screaming. Banner: “I NEED BUZZ”.
Cosmic chicken coop – hens laying star-eggs. Coop spray: “I NEED BUZZ”.
Viking rave – warriors headbanging with axes. Stage tag: “I NEED BUZZ”.
Haunted supermarket – possessed trolleys chasing shoppers. Aisle sign: “I NEED BUZZ”.
Apocalypse circus wedding – clowns officiating, fire juggling. Tent wall: “I NEED BUZZ”.
Intergalactic laundromat riot – wormholes eating socks. Washer door: “I NEED BUZZ”.